1111111111111111111111111111111111111
10010000000C10000000001C0000C000000E1
100C011111001001C0000C000000001110001
1P00110000000011111111100000001111111
10000000C0110000111000000000000000001
1000C1111100000010000000000C001000011
10000000001111000000000000C0000000001
1111000C00000000000000000000000000001
1001100000000011111111111100000000001
1111111111111111111111111111111111111