11111111111111
1PC0000C111111
1000C000C01111
100111C00000E1
100C00000C0111
11111111111111