1111111111111
1P0000C00E101
1111111111111