11111111111111
10C0000C111111
1000C000C01111
100111C00001E1
100C00000C01P1
11111111111111