1111111111111111111111111111
10000000000P0000000000000001
1011101110101111010111011101
1000100010C01000100010001001
1011100011101110111000111001
1000100010001000100010001101
10111011101011110101110111E1
10000000000000000000000000C1
1111111111111111111111111111