1111111111111
1001P0000E1C1
1000011110111
1000110101011
1111111111111