11111111111111111111
10P00000001100000111
10110000011100000101
10111000001111000101
101110C1111111C00101
10110000011100000101
10011110000000000E01
11111111111111111111